############
#..........#
#..........#
#..........#
#..##..##..#
#..#....#..#
#..#....#..#
#..##..##..#
#..........#
#..........#
#..........#
############
